-------------------------------------------------------------------------------
-------------------------------------------------------------------------------
----############---------------------------------------------------------------
-------------------------------------------------------------------------------
-------------------------------------------------------------------------------
---------------------------------------#######---------------------------------
-------------------------------------------------------------------------------
----------A--------------------------------------------------------------------
-------#######-----------------------------------------------------------------
----##############-------------------------------------------------------------
###############################################################################
