#############################
#---------------------------#
#---------------------------#
#---------------------------#
#---------------------------#
#---------------------------#
#---------------------------#
#---------------------------#
#---------------------------#
#---------------------------#
#---------------------------#
#---------------------------#
#---------------------------#
#---------------------------#
#---------------------------#
#-------------------??------#
#-------------------??------#
#---------------------------#
#---------------------------#
#---------------------------#
#---------------------------#
#---------------------------#
#---------------------------#
#---------------------------#
#---------------------------#
#---------------------------#
#---------------------------#
#---------------------------#
#---------------------------#
#############################
