#############################################
#-------------------------------------------#
#-------------------------------------------#
#-------------------------------------------#
#-------------------------------------------#
#-------------------------------------------#
#-------------------------------------------#
#-------------------------------------------#
#-----P-------------------------------------#
#----###------------------------------------#
#-------------------------------------------#
#############################################
