#########
#-------#
#---#####
#-------#
#-------#
#-------#
#-------#
#-------#
#-------#
#########
