#############################
#---------------------------#
#---------------------------#
#---------------------------#
#---------------------------#
#---------------------------#
#---------------------------#
#---------------------------#
#-----P---------------------#
#----###--------------------#
#---------------------------#
#############################
