-----------------------------------------------------
--------------------#########--####-#####------------
-###-########-##---------------------------####--####
-----------------------------------------------------
#####################################################